1,1,1,1,1,1,1,1,1,1,1,1,1,1,1,1,1,1,1,1,1,1,1,1,1-
1,4,5,5,5,5,5,5,5,5,5,5,5,5,5,5,5,5,5,5,5,5,5,4,1-
1,5,1,5,5,5,1,1,1,1,1,1,1,1,1,1,1,1,1,5,5,5,1,5,1-
1,5,1,5,1,5,5,5,5,5,0,0,5,0,0,5,5,5,5,5,1,5,1,5,1_
1,5,1,5,1,5,1,5,5,5,1,1,1,1,1,5,5,5,1,5,1,5,1,5,1-
1,2,1,5,1,5,1,5,1,5,5,5,5,5,5,5,1,5,1,5,1,5,1,5,1-
1,5,1,5,1,5,1,5,1,5,1,0,1,0,1,5,1,5,1,5,1,5,1,5,1-
1,5,1,5,1,5,1,5,1,5,1,0,0,0,1,5,1,5,1,5,1,5,1,5,1-
1,5,1,5,1,5,1,5,1,5,1,3,5,6,1,5,1,5,1,5,1,5,1,5,1-
1,5,1,5,1,5,1,5,1,5,1,5,5,5,1,5,1,5,1,5,1,5,1,5,1-
1,5,1,5,1,5,1,5,1,5,1,7,5,8,1,5,1,5,1,5,1,5,1,5,1-
1,5,1,5,1,5,1,5,1,5,1,0,0,0,1,5,1,5,1,5,1,5,1,5,1-
1,5,1,5,1,5,1,5,1,5,1,0,1,0,1,5,1,5,1,5,1,5,1,5,1-
1,5,1,5,1,5,1,5,1,5,5,5,5,5,5,5,1,5,1,5,1,5,1,5,1-
1,5,1,5,1,5,1,5,5,5,1,1,1,1,1,5,5,5,1,5,1,5,1,5,1-
1,5,1,5,1,5,5,5,5,5,0,0,0,0,0,5,5,5,5,5,1,5,1,5,1-
1,5,1,5,5,5,1,1,1,1,1,1,1,1,1,1,1,1,1,5,5,5,1,5,1-
1,4,5,5,5,5,5,5,5,5,5,5,5,5,5,5,5,5,5,5,5,5,5,4,1-
1,1,1,1,1,1,1,1,1,1,1,1,1,1,1,1,1,1,1,1,1,1,1,1,1-
#